Date,Balance Amount,Transaction_Amount,Type,Recipient
2024-12-16,16822.55,242.54,DR,Zomato
2024-12-16,16649.55,173.0,DR,ZOMATO
2024-12-16,16619.55,30.0,DR,SHRI G
2024-12-16,16639.55,20.0,CR,Master
2024-12-17,16374.55,265.0,DR,SHREE 
2024-12-17,16449.55,75.0,CR,VIVEK 
2024-12-17,16099.55,350.0,DR,COFFEE
2024-12-17,16274.55,175.0,CR,VIVEK 
2024-12-18,16206.55,68.0,DR,SANJAY
2024-12-18,16131.55,75.0,DR,SAGAR 
2024-12-18,16061.55,70.0,DR,SHRI G
2024-12-18,16151.55,90.0,CR,Master
2024-12-18,15871.55,280.0,DR,COFFEE
2024-12-19,15851.55,20.0,DR,ANIL N
2024-12-19,15681.55,170.0,DR,Prasha
2024-12-20,15381.55,300.0,DR,SAKET 
2024-12-20,15171.55,210.0,DR,SANJAY
2024-12-20,15161.55,10.0,DR,DHIRAJ
2024-12-20,15155.55,6.0,DR,SANJAY
2024-12-20,15215.55,60.0,CR,Master
2024-12-20,15180.55,35.0,DR,SAKET 
2024-12-20,15040.55,140.0,DR,SAMBHA
2024-12-21,14697.21,343.34,DR,ZOMATO
2024-12-21,14667.21,30.0,DR,PRATIK
2024-12-21,14360.52,306.69,DR,Unknown
2024-12-21,13996.52,364.0,DR,Zomato
2024-12-21,14066.52,70.0,CR,Mr NAM
2024-12-21,13506.52,560.0,DR,VIVEK 
2024-12-22,13334.52,172.0,DR,ZOMATO
2024-12-23,13313.52,21.0,DR,Mr NIL
2024-12-23,13177.77,135.75,DR,Unknown
2024-12-23,12981.69,196.08,DR,ZOMATO
2024-12-23,12581.69,400.0,DR,REVIVE
2024-12-23,12405.3,176.39,DR,ZOMATO
2024-12-24,12362.3,43.0,DR,ABHIMA
2024-12-24,12312.3,50.0,DR,SHIVAM
2024-12-24,12302.3,10.0,DR,SHIVAM
2024-12-25,12182.3,120.0,DR,KALAL 
2024-12-25,12113.3,69.0,DR,Jio Pr
2024-12-29,11607.3,506.0,DR,SHALEM
2024-12-29,11538.3,69.0,DR,Jio Pr
2025-01-01,10538.3,1000.0,DR,Mrs AN
2025-01-02,10383.3,155.0,DR,Minesh
2025-01-02,10293.3,90.0,DR,Mr ABD
2025-01-03,10258.3,35.0,DR,Minesh
2025-01-04,10228.3,30.0,DR,VIKASJ
2025-01-04,7561.3,2667.0,DR,Mr LAU
2025-01-06,8061.3,500.0,CR,VIVEK 
2025-01-12,8026.3,35.0,DR,NEPALS
2025-01-12,7981.3,45.0,DR,HEERAL
2025-01-14,22981.3,15000.0,CR,Unknown
2025-01-15,22917.3,64.0,DR,Biodat
2025-01-15,22865.3,52.0,DR,RAZORP
2025-01-15,22796.3,69.0,DR,Jio Pr
2025-01-16,22541.42,254.88,DR,Unstop
2025-01-16,22489.42,52.0,DR,RAZORP
2025-01-16,21690.42,799.0,DR,Jio Pr
2025-01-18,21674.42,16.0,DR,BSNL R
2025-01-18,21663.42,11.0,DR,BSNL R
2025-01-20,20816.42,847.0,DR,Mr LAU
2025-01-25,20776.42,40.0,DR,YUSUF 
2025-01-25,20711.42,65.0,DR,Minesh
2025-01-29,20641.42,70.0,DR,KALAL 
2025-01-29,20051.42,590.0,DR,KALAL 
2025-01-29,20021.42,30.0,DR,VADA  
2025-01-31,18610.64,1410.78,DR,Zepto
2025-01-31,18471.0,139.64,DR,Zomato
2025-01-31,18611.0,140.0,CR,VIVEK 
2025-01-31,18592.0,19.0,DR,Jio Pr
2025-01-31,18296.75,295.25,DR,Zomato
2025-02-01,14796.75,3500.0,DR,PRAMOD
2025-02-01,14768.75,28.0,DR,Mr NIL
2025-02-01,14758.75,10.0,DR,KAGAZ 
2025-02-01,14678.75,80.0,DR,JAYESH
2025-02-01,14418.75,260.0,DR,DAIRY 
2025-02-02,14333.75,85.0,DR,Vandan
2025-02-02,14314.75,19.0,DR,Jio Pr
2025-02-02,14245.75,69.0,DR,Jio Pr
2025-02-02,13881.41,364.34,DR,ZOMATO
2025-02-03,13581.41,300.0,DR,Dr Bat
2025-02-03,13579.41,2.0,DR,19:21:07
2025-02-04,13480.41,99.0,DR,NOLAN 
2025-02-04,13320.41,160.0,DR,JAYESH
2025-02-04,13280.41,40.0,DR,SHRI G
2025-02-04,13281.41,1.0,CR,Cashfr
2025-02-05,13044.12,237.29,DR,Zomato
2025-02-05,13037.12,7.0,DR,Mr NIL
2025-02-05,12747.01,290.11,DR,Unknown
2025-02-05,12707.01,40.0,DR,Unknown
2025-02-06,12709.01,2.0,CR,R01
2025-02-06,12679.01,30.0,DR,Mr SAC
2025-02-06,12649.01,30.0,DR,Mr SAC
2025-02-06,12679.01,30.0,CR,VIVEK 
2025-02-06,12669.01,10.0,DR,New Ma
2025-02-06,12649.01,20.0,DR,Ashirw
2025-02-06,9983.01,2666.0,DR,Mr LAU
2025-02-07,9643.01,340.0,DR,Zomato
2025-02-07,9499.01,144.0,DR,Zomato
2025-02-07,9485.01,14.0,DR,Mr NIL
2025-02-08,9568.01,83.0,CR,Unknown
2025-02-08,9493.01,75.0,DR,SANJAY
2025-02-08,9993.01,500.0,CR,VIVEK 
2025-02-08,9779.01,214.0,DR,DATTAT
2025-02-09,9709.01,70.0,DR,SHRI G
2025-02-09,9640.01,69.0,DR,Jio Pr
2025-02-10,8640.01,1000.0,DR,JAYESH
2025-02-10,8670.01,30.0,CR,HITESH
2025-02-10,8520.01,150.0,DR,SWAPNI
2025-02-11,8280.01,240.0,DR,ZOMATO
2025-02-11,8278.01,2.0,DR,MEHULB
2025-02-11,8258.01,20.0,DR,Ashirw
2025-02-12,8238.01,20.0,DR,SAGAR 
2025-02-12,8098.01,140.0,DR,ZOMATO
2025-02-13,8038.01,60.0,DR,SANJAY
2025-02-13,8018.01,20.0,DR,KAMBLE
2025-02-13,7949.01,69.0,DR,Jio Pr
2025-02-13,7589.01,360.0,DR,KANCHA
2025-02-13,7559.01,30.0,DR,New Ma
2025-02-14,7658.01,99.0,CR,RRC
2025-02-14,7644.01,14.0,DR,Mr NIL
2025-02-15,7609.01,35.0,DR,NASEEM
2025-02-15,7607.01,2.0,DR,MEHULB
2025-02-15,7589.01,18.0,DR,NMC
2025-02-15,7559.01,30.0,DR,GITA A
2025-02-15,7534.01,25.0,DR,SAGAR 
2025-02-15,7434.01,100.0,DR,Master
2025-02-16,7394.01,40.0,DR,SHRI G
2025-02-16,7376.31,17.7,DR,Unknown
2025-02-17,6992.31,384.0,DR,ZOMATO
2025-02-17,7012.31,20.0,CR,Master
2025-02-17,6937.31,75.0,DR,PURPLE
2025-02-18,6774.31,163.0,DR,ZOMATO
2025-02-18,6714.31,60.0,DR,Ashirw
2025-02-18,6774.31,60.0,CR,VIVEK 
2025-02-19,1774.31,5000.0,DR,Mr LAU
2025-02-19,1755.31,19.0,DR,Jio Pr
2025-02-19,1725.31,30.0,DR,New Ma
2025-02-20,1723.31,2.0,DR,MEHULB
2025-02-20,1603.31,120.0,DR,Mr SAC
2025-02-20,1573.31,30.0,DR,LAXMI 
2025-02-20,1549.91,23.4,DR,Unknown
2025-02-20,1529.91,20.0,DR,Ashirw
2025-02-21,1391.91,138.0,DR,Zomato
2025-02-21,1322.91,69.0,DR,Jio Pr
2025-02-21,1293.91,29.0,DR,Jio Pr
2025-02-22,969.67,324.24,DR,Zomato
2025-02-22,909.67,60.0,DR,SAGAR 
2025-02-22,876.67,33.0,DR,ANIL N
2025-02-23,728.67,148.0,DR,SANJAY
2025-02-23,698.67,30.0,DR,SANJAY
2025-02-23,728.67,30.0,CR,Mr NAM
2025-02-23,788.67,60.0,CR,Master
2025-02-23,596.67,192.0,DR,Zomato
2025-02-24,25596.67,25000.0,CR,Unknown
2025-02-24,25471.67,125.0,DR,Mr SAC
2025-02-24,25501.67,30.0,CR,SAKET 
2025-02-24,25531.67,30.0,CR,Bhagys
2025-02-24,25561.67,30.0,CR,Arjun
2025-02-24,25551.67,10.0,DR,Arjun
2025-02-24,25546.67,5.0,DR,MEHULB
2025-02-24,25531.67,15.0,DR,CHAITA
2025-02-24,25491.67,40.0,DR,LAXMI 
2025-02-24,25218.0,273.67,DR,Unknown
2025-02-24,25149.0,69.0,DR,Jio Pr
2025-02-25,24715.0,434.0,DR,Zomato
2025-02-25,24765.0,50.0,CR,VIVEK 
2025-02-25,24685.0,80.0,DR,HOTEL 
2025-02-25,24655.0,30.0,DR,Ashirw
2025-02-25,24463.51,191.49,DR,ZOMATO
2025-02-26,24398.51,65.0,DR,SANJAY
2025-02-26,24378.51,20.0,DR,GITA A
2025-02-26,24348.51,30.0,DR,New Ma
2025-02-27,23998.51,350.0,DR,ZOMATO
2025-02-27,23868.51,130.0,DR,VIVEK 
2025-02-27,23712.51,156.0,DR,Zomato
2025-02-27,23652.51,60.0,DR,Matosh
2025-02-27,23672.51,20.0,CR,VIVEK 
2025-02-28,23472.51,200.0,DR,HOTEL 
2025-02-28,23462.51,10.0,DR,Ashirw
2025-02-28,23562.51,100.0,CR,VIVEK 
2025-02-28,23491.66,70.85,DR,Unknown
2025-02-28,23426.66,65.0,DR,SAGAR 
2025-02-28,23088.66,338.0,DR,VILAS 
2025-02-28,29088.66,6000.0,CR,VIVEK 
2025-02-28,31088.66,2000.0,CR,Master
2025-02-28,33088.66,2000.0,CR,Dipesh
2025-02-28,33087.66,1.0,DR,Unknown
2025-02-28,33086.66,1.0,DR,Unknown
2025-02-28,32996.66,90.0,DR,Bholes
2025-02-28,20996.66,12000.0,DR,Unknown
2025-02-28,20916.66,80.0,DR,ROHIT 
2025-02-28,20866.66,50.0,DR,RUDRAY
2025-03-01,20806.66,60.0,DR,Shreek
2025-03-01,20826.66,20.0,CR,VIVEK 
2025-03-01,20806.66,20.0,DR,SAGAR 
2025-03-01,20618.71,187.95,DR,DOMINO
2025-03-01,20448.71,170.0,DR,COFFEE
2025-03-01,20607.71,159.0,CR,VIVEK 
2025-03-01,20704.71,97.0,CR,Dipesh
2025-03-02,20680.71,24.0,DR,Unknown
2025-03-02,20632.71,48.0,DR,Unknown
2025-03-02,19630.71,1002.0,DR,VIVEK 
2025-03-02,19560.71,70.0,DR,PATEL 
2025-03-03,19260.71,300.0,DR,KAILAS
2025-03-03,19140.71,120.0,DR,MADANL
2025-03-03,19105.71,35.0,DR,VINODK
2025-03-03,19205.71,100.0,CR,VIVEK 
2025-03-04,18994.47,211.24,DR,ZOMATO
2025-03-04,18934.47,60.0,DR,POORAN
2025-03-05,18876.47,58.0,DR,Mr SAV
2025-03-05,18716.47,160.0,DR,BHAVES
2025-03-05,18664.47,52.0,DR,PATEL 
2025-03-05,18831.47,167.0,CR,Mr LAU
2025-03-05,18931.47,100.0,CR,Dipesh
2025-03-05,19012.47,81.0,CR,Mr NAM
2025-03-06,18870.53,141.94,DR,Zomato
2025-03-06,18572.33,298.2,DR,DOMINO
2025-03-06,18472.33,100.0,DR,MONICA
2025-03-06,18412.33,60.0,DR,POORAN
2025-03-07,19412.33,1000.0,CR,VIVEK 
2025-03-07,19166.33,246.0,DR,EKART
2025-03-07,19108.33,58.0,DR,KACHRU
2025-03-07,19088.33,20.0,DR,Sunita
2025-03-08,18793.33,295.0,DR,SHREE 
2025-03-08,18843.33,50.0,CR,VIVEK 
2025-03-08,18823.33,20.0,DR,SAI HA
2025-03-08,18718.33,105.0,DR,Mr SAV
2025-03-09,18638.33,80.0,DR,SHIVAN
2025-03-09,18558.33,80.0,DR,BHAVES
2025-03-09,18488.33,70.0,DR,Mr SAV
2025-03-09,18467.33,21.0,DR,BHAVES
2025-03-09,18497.33,30.0,CR,Master
2025-03-09,18477.33,20.0,DR,Razorp
2025-03-10,18448.84,28.49,DR,Wellne
2025-03-10,18403.84,45.0,DR,NEW BL
2025-03-10,18413.84,10.0,CR,Master
2025-03-10,18242.84,171.0,DR,ZEPTO 
2025-03-10,18164.84,78.0,DR,BHAVES
2025-03-10,17954.84,210.0,DR,COFFEE
2025-03-10,17884.84,70.0,DR,COFFEE
2025-03-10,17844.84,40.0,DR,Mr SAV
2025-03-11,17865.84,21.0,CR,Unknown
2025-03-11,17825.84,40.0,DR,PATEL 
2025-03-11,17317.84,508.0,DR,Mr LAU
2025-03-11,17232.84,85.0,DR,Mr SAV
2025-03-12,17216.84,16.0,DR,Pawar 
2025-03-12,17296.84,80.0,CR,VIVEK 
2025-03-12,17136.84,160.0,DR,BHAVES
2025-03-12,17116.84,20.0,DR,PATEL 
2025-03-12,17166.84,50.0,CR,VIVEK 
2025-03-12,17026.84,140.0,DR,Mr SAV
2025-03-13,16886.84,140.0,DR,HOTEL 
2025-03-13,15875.04,1011.8,DR,Qviple
2025-03-13,15755.04,120.0,DR,POORAN
2025-03-13,15842.04,87.0,CR,Master
2025-03-13,15734.04,108.0,DR,Mr SAV
2025-03-13,15798.04,64.0,CR,Dipesh
2025-03-13,15778.04,20.0,DR,Dipesh
2025-03-14,12578.04,3200.0,DR,SL NAS
2025-03-14,12568.04,10.0,DR,PATEL 
2025-03-14,12448.04,120.0,DR,BHAVES
2025-03-14,10448.04,2000.0,DR,VIVEK 
2025-03-14,10302.04,146.0,DR,ZOMATO
2025-03-15,10282.04,20.0,DR,Mr KIR
2025-03-15,10162.04,120.0,DR,BHAVES
2025-03-15,10154.04,8.0,DR,MEHULB
2025-03-15,10104.04,50.0,DR,JANHAV
2025-03-15,9104.04,1000.0,DR,Master
2025-03-15,9046.16,57.88,DR,Unknown
2025-03-15,8996.16,50.0,DR,Mr SAV
2025-03-15,8926.16,70.0,DR,Kailas
2025-03-16,8906.16,20.0,DR,THALAI
